stæf	stæfs	
sElf	sElvz	
hæf	hævz	
sef	sevz	
Cif	Civz	
wYf	wYvz	
brif	brifs	
pEr@ɡræf	pEr@ɡræfs	
rIlif	rIlivz	
pruf	prufs	
rEf	rEfs	
bIhæf	bIhævz	
ɡræf	ɡræfs	
ɡ^lf	ɡ^lvz	
ruf	ruvz	
lif	livz	
wUlf	wUlvz	
SEf	SEfs	
b@lif	b@lifs	
prAf	prAfs	
SElf	SElvz	
læf	lævz	
nYf	nYvz	
motif	motivz	
SErIf	SErIfs	
plentIf	plentIvz	
tErIf	tErIfs	
rif	rivz	
klIf	klIfs	
tRf	tRfs	
trY@mf	trY@mfs	
tIf	tIvz	
Elf	Elvz	
sErIf	sErIfs	
Tif	Tivz	
kAf	kAfs	
bl^f	bl^fs	